25/25
WWWWWWWWWWWWWWWWWWWWWWWWW
W.....W.........W.......W
W.....W.........W.......W
W.....W.........W.......W
WWW..WW.................W
W.......................W
W...............WWWWWW..W
W.......................W
W.......................W
W.......................W
W.......................W
WWWWWWWW................W
W......W................W
W......W................W
W......WWWWWWWW..WWWWWWWW
W.......................W
W.......................W
W.......................W
WWWWWWWWWWWWWWWWWWWWWWWWW